NO ./pics/greystone.png
SO    ./pics/redbrick.png
WE ./pics/eagle.png
EA ./pics/pillar.png

F 220,  100,0
C 225,30,0


1111111
100C001
100N001
1000101
1111 11