NO ./pics/wall1.png
SO    ./pics/wall5.png

EA ./pics/wall9.png

F 0,  0,255
C 225,0,0


WE ./pics/wall13.png
        1111111111111111111111111
        1000000000110000000000001
        1011000001110000000000001
        1001000000000000000000001
111111111011000001110000000000001
100000000011000001110111111111111
111101111111110111000D00D0001
11110111111111011101010010001
11000000110101011100000010C01
10000000000000001100000010001
10000000000000001101010010001
11000001110101011111011110N01
11110111 1110101 101111010001
1111011 1111111 111111111111
