NO ./pics/greystone.png
SO    ./pics/redbrick.png
WE ./pics/eagle.png
EA ./pics/pillar.png

F 220,  100,0
C 225,30,0


1111111
100C001
1000001
10N01D1
1111111